....................................................................................................
..............................***********.***.*****.*****.***********...............................
.............................*           *   *     *     *           *..............................
.............................* *** ***** * * *** *** * * *** ******* *..............................
.............................* *   *   *   *   * *   * *   *   *   * *..............................
.............................* * *** * ****.** * * *** *** * * *** * *..............................
.............................* * * * *     *   * *   *   * * *   * * *..............................
.............................* * * * ***** * *** * ***** * * *** * * *..............................
.............................* * * *     * * *     *     * * *   *   *..............................
.............................* * * ***** * * ***** * ***** * * *** **...............................
.............................* * *       * *     * *   * * * * *   * *..............................
..............................** * ******* ***** * *** * * * * *** * *..............................
.............................*   *   *     *     * *   *   * *   *   *..............................
.............................* **.** * * *** ******* *** ******* *** *..............................
.............................*   * * * * *   *     *   * *     * *   *..............................
.............................* * * * * * * *** *** *** * * *** * ****...............................
.............................* * * * * * *     *       *   * * *     *..............................
..............................** * * * ******* ************* * * *** *..............................
.............................*   *   *         *   *     *   * *   * *..............................
.............................* **.************** * * ***** * * ***** *..............................
.............................*   *     *     *   * *       *   *     *..............................
.............................* * * *** * *** * *** * ******.**** *** *..............................
.............................* *   * * * * * *   *.*   *   *   *   * *..............................
.............................* ***** * * * * *** ***** * * * *** * * *..............................
.............................*       * *   *     *       * * *   * * *..............................
..............................****** * *** *************** * * *** * *..............................
.............................*   *   * *   *             * *   *   * *..............................
.............................* *** *** * ********* ***** * ***** *** *..............................
.............................* *   *   *           *     *     * *   *..............................
.............................* * *** *************** ********* * *** *..............................
.............................*     *     *     *   *       *   *   * *..............................
.............................* ******* * * *** *** ******* * *** * **...............................
.............................*   *     *   *       *     * * *   *   *..............................
.............................* *** ********* ******* * *** * ******* *..............................
.............................* *   *     *   *       * *   *   *     *..............................
.............................* * *** *** ***** ******* * ***** * *** *..............................
.............................* *   *   * *     * *     * *   * * *   *..............................
.............................* *** *** * * ***** * *** * * *** * *** *..............................
.............................*   *     * * *   * * *   * *     *   * *..............................
..............................** ******* * * * * * ***** * ******* * *..............................
.............................*        O*     *   *       *         * *..............................
..............................*********.*****.***.*******.*********.*...............................
....................................................................................................